******************************
*                            *
*                        t   *
*####################        *
*                            *
*                           **
*    t      t   *        *** *
*               *      **    *
*               *            *
*               ****         *
******              **       *
***                  *        
*       ######            ****
*                 t      *****
*                       ******
****                   *******
******************************
